0000000000000000000000000000000000000000000000000000000000000000000000000000000000000000000000000000
0000000000000000000000000000000000000000000000000001111111100000000000111111111111100000000000000000
0000000000000000000000011111110000011111111110000001111111100000000000111111111111100000000000000000
0000000000000000000000011111110000011111111110000001111111100000000000111111111111100000011111111000
0000000000000000000000011111110000011111111110000001111111100000000000111111111111100000011111111000
0000000000000000000000011111110000011111111110000001111111100000000000111111111111100000011111111000
0000000000000000000000011111110000011111111110000000020000000000000000111111111111100000011111111000
0000000000000000000000011111110000011111111110000000020000000000000000111111111111100000011111111000
0000000000000000000000011111110000011111111110000111111110000000000000111111111111100000011111111000
0111111111111111111100011111110000011111111110000111111110000000000000111111111111100000011111111000
0111111111111111111100011111110000000002000000000111111110000000000000111111111111100000011111111000
0111111111111111111100011111110000000002000000000111111110000000000000111111111111100000011111111000
0111111111111111111122211111112222222222000000000111111110000000000000111111111111100000000020000000
0111111111111111111100011111110000000002000000000111111110000000000000111111111111100000000020000000
0111111111111111111100011111110000000002000000000111111110000000000000111111111111100000000020000000
0111111111111111111100011111110000000002000000000000020000000000000000000200000000000000000020000000
0111111111111111111100011111110000000002000000000000020000000000000000000200000000000000000020000000
0111111111111111111100020000000000000002000000000000020000000000000000000200000000000000000020000000
0111111111111111111100020000000000000002000000000000022222222222222222222222222222222222222220000000
0111111111111111111100020000000000000011111110011111110000000000000000000200000000000000000020000000
0111111111111111111100020000000000000011111110011111110000000000000000000200000000000000000020000000
0000000000000000000000020000000000000011111110011111110000000000000000000200000000000000000020000000
0000000000000000000000020000000000000011111110011111110000000000000000000200000000000000000020000000
0000000000000000000000020000000000000000000000000000020000000000000000000200000000000000000020000000
0000000000000000000000020000000000000000000000000000020000000000000111111111110000000011111111111110
0000000111111111111100020000000000000000000000000000020000000000000111111111110000000011111111111110
0000000111111111111100020000000000000000000000000011111110000000000111111111110000000011111111111110
0000000111111111111100020000000000000000000000000011111110000000000111111111110000000011111111111110
0000000111111111111100020000000000000000000000000011111110000000000111111111110000000011111111111110
0000000111111111111100020000000000000000000000000011111110000000000111111111110000000011111111111110
0000000111111111111100020000000000000000000000000011111110000000000111111111110000000011111111111110
0000000111111111111100111111111111100000000000000011111110000000000111111111110000000011111111111110
0000000111111111111100111111111111100000000000000011111110000000000111111111110000000011111111111110
0000000111111111111100111111111111100000000000000011111110000000000111111111110000000000000000000000
0000000111111111111100111111111111100000000000000011111110000000000111111111110000000000000000000000
0000000111111111111100111111111111100000000000000011111110000000000000000200000000000000000000000000
0000000111111111111100111111111111100000000000000000000000000000000000000200000000000000000000000000
0000000111111111111100111111111111100000000000000000000000000000000000000200000000000000000000000000
0000000111111111111100111111111111100000000000000000000000000000000000000200000000000000000000000000
0000000000200000000000111111111111100000000000000000000000000000011111111200000000000000000000000000
0000000000200000000000111111111111100000000000000000000000000000011111111200000000000000000000000000
0000000000200000000000111111111111100000000000000000000000000000011111111200000011111111111111111110
0000000000200000000000111111111111100000000000011111111110000000011111111200000011111111111111111110
0000000000222222222222111111111111100000000000011111111110000000011111111200000011111111111111111110
0000000111111111111100111111111111100000000000011111111110000000011111111200000011111111111111111110
0000000111111111111100020000000002000000000000011111111110000000011111111200000011111111111111111110
0000000111111111111100020000000002000000000000011111111110000000011111111200000011111111111111111110
0000000111111111111100020000000002000000000000011111111110000000011111111200000011111111111111111110
0000000111111111111100020000000002000000000000011111111110000000011111111200000011111111111111111110
0000000111111111111100011111111111111110000000011111111110000000011111111200000011111111111111111110
0000000111111111111100011111111111111112222222211111111112222222211111111200000011111111111111111110
0000000111111111111100011111111111111110000000011111111110000000011111111200000000000000200000000000
0000000111111111111100011111111111111110000000011111111112222222211111111222222222222222200000000000
0000000111111111111100011111111111111110000000011111111110000000011111111200000000000000200000000000
0000000111111111111100011111111111111110000000011111111110000000011111111200000000000000200000000000
0000000111111111111100011111111111111110000000011111111110000000011111111200000000001111111111111110
0000000111111111111100011111111111111110000000011111111110000000011111111200000000001111111111111110
0000000111111111111100020000000000000000000000011111111110000000011111111200000000001111111111111110
0000000111111111111100020000000000000000000000011111111110000000011111111200000000001111111111111110
0000000111111111111100020000000000000000000000011111111110000000000000000200000000001111111111111110
0000000111111111111100020000000000000000000000000000000000000000000000000200000000001111111111111110
0000000000000000000000020000000000000000000000000000000000000000000000000200000000001111111111111110
0000000000000000000000020000000000000000000000000000000000000000000000000200000000001111111111111110
0000000000000000000000020000000000000000000000000000000000000000000000000200000000001111111111111110
0000000000000000000000020000000000000000000000000000000000000000000000000200000000001111111111111110
0000000000000000000000020000000000000000000000000000000000000000000000000200000000000000000000000000
0011111100000000000000020000111111111111000000000000000000000000000000000200000000000000000000000000
0011111100000000000000020000111111111111000000000000000000000000000000000200000000000000000000000000
0011111100000001111111110000111111111111000000000000000000000000000000000200000000111111111111000000
0011111122222221111111110000111111111111000000000000000000000000000000000200000000111111111111000000
0011111100000201111111110000111111111111000000000000000000000000000000000200000000111111111111000000
0011111100000201111111110000111111111111000000000000000000000000000000000200000000111111111111000000
0011111100000201111111110000000000002000000000000000000000000000000000000200000000111111111111000000
0011111100000201111111110000000000002000000000000000000000000000000000000200000000111111111111000000
0011111100000201111111110000000000002000000000000000000000000000000000000200000000111111111111000000
0000000000000200000000020000000000002000000000000000000000000000000000000200000000000000002000000000
0000000000000200000000020000000000002000000000000000000000000000000000000200000000000000002000000000
0000000000000200000000020000001111111111111100001111111111000000000000000200000000000000002000000000
0000000011111111111111110000001111111111111100001111111111000000011111111111111000000000002000000000
0000000011111111111111110000001111111111111100001111111111000000011111111111111000000000002000000000
0000000011111111111111110000001111111111111100001111111111000000011111111111111000000000002000000000
0000000011111111111111112222221111111111111100001111111111000000011111111111111000000000002000000000
0000000011111111111111110000001111111111111100001111111111000000011111111111111000000000111111111110
0000000011111111111111110000001111111111111100001111111111222222211111111111111222222222111111111110
0000000011111111111111110000001111111111111100001111111111000000011111111111111000000000111111111110
0000000011111111111111110000000000002000000000001111111111000000011111111111111000000000111111111110
0000000011111111111111110000000000002000000000001111111111000000011111111111111000000000111111111110
0000000000000200000000000000000000002000000000001111111111000000011111111111111000000000111111111110
0000000000000200000000000000000000002000000000001111111111000000011111111111111000000000111111111110
0000000000000200000000000000000000002000000000001111111111000000011111111111111000000000111111111110
0000000000000200000000000000111111102000000000001111111111000000011111111111111000000000111111111110
0000000011111111111111000000111111102000000000001111111111000000011111111111111000000000111111111110
0000000011111111111111000000111111102000000000001111111111000000011111111111111000000000111111111110
0000000011111111111111000000111111102011111110001111111111000000011111111111111000000000111111111110
0000000011111111111111000000111111122211111110001111111111000000011111111111111000000000000000000000
0000000011111111111111000000000000000011111110001111111111000000011111111111111000000000000000000000
0000000011111111111111000000000000000011111110001111111111000000011111111111111000000000000000000000
0000000011111111111111000000000000000011111110000000000000000000000000000000000000000000000000000000
0000000011111111111111000000000000000011111110000000000000000000000000000000000000000000000000000000
0000000000000000000000000000000000000000000000000000000000000000000000000000000000000000000000000000
